eine (for feminine) [sound:german-eine (for feminine).mp3]	a (indefinite article)
die Fähigkeit [sound:german-die Fähigkeit.mp3]	ability
fähig [sound:german-fähig.mp3]	able, capable
etwa [sound:german-etwa.mp3]	about (circa)
über [sound:german-über.mp3]	about (concerning)
über, darüber [sound:german-über, darüber.mp3]	above
im Ausland [sound:german-im Ausland.mp3]	abroad
abwesend [sound:german-abwesend.mp3]	absent
annehmen [sound:german-annehmen.mp3]	accept
der Unfall [sound:german-der Unfall.mp3]	accident
das Konto [sound:german-das Konto.mp3]	account
erreichen [sound:german-erreichen.mp3]	achieve
durch [sound:german-durch.mp3]	across (through)
handeln [sound:german-handeln.mp3]	act (verb)
die Handlung [sound:german-die Handlung.mp3]	action
die Tätigkeit [sound:german-die Tätigkeit.mp3]	activity
der Schauspieler [sound:german-der Schauspieler.mp3]	actor
die Schauspielerin [sound:german-die Schauspielerin.mp3]	actress
tatsächlich [sound:german-tatsächlich.mp3]	actual
eigentlich [sound:german-eigentlich.mp3]	actually
hinzufügen [sound:german-hinzufügen.mp3]	add
zusätzlich [sound:german-zusätzlich.mp3]	added
beigefügt [sound:german-beigefügt.mp3]	additional
die Adresse [sound:german-die Adresse.mp3]	address
angemessen [sound:german-angemessen.mp3]	adequate
die Verwaltung [sound:german-die Verwaltung.mp3]	administration
erwachsen [sound:german-erwachsen.mp3]	adult
fortgeschritten [sound:german-fortgeschritten.mp3]	advanced
der Vorteil [sound:german-der Vorteil.mp3]	advantage
die Werbung [sound:german-die Werbung.mp3]	advertising
der Rat [sound:german-der Rat.mp3]	advice
Geschäfte, pl [sound:german-Geschäfte, pl.mp3]	affairs (plural)
besorgt [sound:german-besorgt.mp3]	afraid
nach [sound:german-nach.mp3]	after
darnach [sound:german-darnach.mp3]	after that
der Nachmittag [sound:german-der Nachmittag.mp3]	afternoon
nachher [sound:german-nachher.mp3]	afterwards
wieder [sound:german-wieder.mp3]	again
gegen [sound:german-gegen.mp3]	against
das Alter [sound:german-das Alter.mp3]	age
vor [sound:german-vor.mp3]	ago
zustimmen [sound:german-zustimmen.mp3]	agree
die Vereinbarung [sound:german-die Vereinbarung.mp3]	agreement
die Hilfe [sound:german-die Hilfe.mp3]	aid (help)
das Ziel [sound:german-das Ziel.mp3]	aim
die Luft [sound:german-die Luft.mp3]	air
das Flugzeug [sound:german-das Flugzeug.mp3]	airplane
der Flughafen [sound:german-der Flughafen.mp3]	airport
der Wecker [sound:german-der Wecker.mp3]	alarm clock
der Alkohol [sound:german-der Alkohol.mp3]	alcohol
lebendig [sound:german-lebendig.mp3]	alive
alle [sound:german-alle.mp3]	all
erlauben [sound:german-erlauben.mp3]	allow
fast [sound:german-fast.mp3]	almost
allein [sound:german-allein.mp3]	alone
entlang [sound:german-entlang.mp3]	along
schon [sound:german-schon.mp3]	already
auch [sound:german-auch.mp3]	also (too)
obwohl [sound:german-obwohl.mp3]	although
immer [sound:german-immer.mp3]	always
unter, zwischen [sound:german-unter, zwischen.mp3]	among
der Betrag [sound:german-der Betrag.mp3]	amount
vergnügen [sound:german-vergnügen.mp3]	amuse
alt [sound:german-alt.mp3]	ancient
und [sound:german-und.mp3]	and
der Winkel [sound:german-der Winkel.mp3]	angle
wütend [sound:german-wütend.mp3]	angry
das Tier [sound:german-das Tier.mp3]	animal
die Fessel [sound:german-die Fessel.mp3]	ankle
ankündigen [sound:german-ankündigen.mp3]	announce
jährlich [sound:german-jährlich.mp3]	annual
die Antwort [sound:german-die Antwort.mp3]	answer
die Ameise [sound:german-die Ameise.mp3]	ant
irgend jemand [sound:german-irgend jemand.mp3]	anyone
irgend etwas [sound:german-irgend etwas.mp3]	anything
irgendwo [sound:german-irgendwo.mp3]	anywhere
die Wohnung [sound:german-die Wohnung.mp3]	apartment
erscheinen [sound:german-erscheinen.mp3]	appear
der Appetit [sound:german-der Appetit.mp3]	appetite
der Apfel [sound:german-der Apfel.mp3]	apple
anwenden [sound:german-anwenden.mp3]	apply
sich nähern [sound:german-sich nähern.mp3]	approach
passend [sound:german-passend.mp3]	appropriate
die Billigung [sound:german-die Billigung.mp3]	approval
ungefähr [sound:german-ungefähr.mp3]	approximately
die Aprikose [sound:german-die Aprikose.mp3]	apricot
der April [sound:german-der April.mp3]	April
das Gebiet [sound:german-das Gebiet.mp3]	area
der Beweis [sound:german-der Beweis.mp3]	argument
der Arm [sound:german-der Arm.mp3]	arm
der Sessel [sound:german-der Sessel.mp3]	armchair
Waffen, pl [sound:german-Waffen, pl.mp3]	arms (plural)
die Armee [sound:german-die Armee.mp3]	army
herum [sound:german-herum.mp3]	around
die Ankunft [sound:german-die Ankunft.mp3]	arrival
ankommen [sound:german-ankommen.mp3]	arrive
die Kunst [sound:german-die Kunst.mp3]	art
der Artikel [sound:german-der Artikel.mp3]	article
die Künstlerin [sound:german-die Künstlerin.mp3]	artist (feminine)
Künstler, der, [sound:german-Künstler, der,.mp3]	artist (masculine)
wie [sound:german-wie.mp3]	as (like)
als [sound:german-als.mp3]	as (when)
bitten [sound:german-bitten.mp3]	to ask (beg)
fragen [sound:german-fragen.mp3]	ask (question)
der Anblick [sound:german-der Anblick.mp3]	aspect
die Versammlung [sound:german-die Versammlung.mp3]	assembly
die Zuweisung [sound:german-die Zuweisung.mp3]	assignment
der Beistand / die Assistenz [sound:german-der Beistand.mp3]&nbsp;[sound:german-die Assistenz.mp3]	assistance
der Verband [sound:german-der Verband.mp3]	association
um [sound:german-um.mp3]	at (hour)
an [sound:german-an.mp3]	at (place)
endlich [sound:german-endlich.mp3]	at last
wenigstens [sound:german-wenigstens.mp3]	at least
höchstens [sound:german-höchstens.mp3]	at most
zur gleichen Zeit [sound:german-zur gleichen Zeit.mp3]	at the same time
angreifen [sound:german-angreifen.mp3]	attack
der Versuch [sound:german-der Versuch.mp3]	attempt
die Achtung [sound:german-die Achtung.mp3]	attention
die Haltung [sound:german-die Haltung.mp3]	attitude
der Anwalt [sound:german-der Anwalt.mp3]	attorney
der August [sound:german-der August.mp3]	August
die Tante [sound:german-die Tante.mp3]	aunt
die Schriftstellerin [sound:german-die Schriftstellerin.mp3]	author (feminine)
Schriftsteller, der, [sound:german-Schriftsteller, der,.mp3]	author (masculine)
der Herbst [sound:german-der Herbst.mp3]	autumn
käuflich [sound:german-käuflich.mp3]	available
vermeiden [sound:german-vermeiden.mp3]	avoid
erwachen [sound:german-erwachen.mp3]	awake
aufgeweckt [sound:german-aufgeweckt.mp3]	aware
weg [sound:german-weg.mp3]	away
[sound:german-.mp3]	
das Baby [sound:german-das Baby.mp3]	baby
zurück [sound:german-zurück.mp3]	back
der Rücken [sound:german-der Rücken.mp3]	back (body)
der Hintergrund [sound:german-der Hintergrund.mp3]	background
der Speck [sound:german-der Speck.mp3]	bacon
schlecht [sound:german-schlecht.mp3]	badly
die Tasche [sound:german-die Tasche.mp3]	bag
das Gepäck [sound:german-das Gepäck.mp3]	baggage
backen [sound:german-backen.mp3]	bake
der Bäcker [sound:german-der Bäcker.mp3]	baker
die Bäckerei [sound:german-die Bäckerei.mp3]	bakery
der Balkon [sound:german-der Balkon.mp3]	balcony
der Ball [sound:german-der Ball.mp3]	ball
die Banane [sound:german-die Banane.mp3]	banana
das Band [sound:german-das Band.mp3]	band
die Bank [sound:german-die Bank.mp3]	bank
die Banknote [sound:german-die Banknote.mp3]	bank note
die Bar [sound:german-die Bar.mp3]	bar
die Grundlage [sound:german-die Grundlage.mp3]	base
beruhen auf [sound:german-beruhen auf.mp3]	based
der Keller [sound:german-der Keller.mp3]	basement
grundlegend [sound:german-grundlegend.mp3]	basic
der Korb [sound:german-der Korb.mp3]	basket
das Bad [sound:german-das Bad.mp3]	bath
das Badezimmer [sound:german-das Badezimmer.mp3]	bathroom
die Schlacht [sound:german-die Schlacht.mp3]	battle
die Bucht [sound:german-die Bucht.mp3]	bay
sein [sound:german-sein.mp3]	be
heissen [sound:german-heissen.mp3]	be called
gültig sein [sound:german-gültig sein.mp3]	be valid
der Strand [sound:german-der Strand.mp3]	beach
die Bohne [sound:german-die Bohne.mp3]	bean
der Bär [sound:german-der Bär.mp3]	bear
der Bart [sound:german-der Bart.mp3]	beard
schlagen [sound:german-schlagen.mp3]	beat
schön [sound:german-schön.mp3]	beautiful
die Schönheit [sound:german-die Schönheit.mp3]	beauty
weil [sound:german-weil.mp3]	because
werden [sound:german-werden.mp3]	become
das Bett [sound:german-das Bett.mp3]	bed
das Schlafzimmer [sound:german-das Schlafzimmer.mp3]	bedroom
die Biene [sound:german-die Biene.mp3]	bee<div><br /></div>
das Rindfleisch [sound:german-das Rindfleisch.mp3]	beef
das Steak [sound:german-das Steak.mp3]	beefsteak
das Bier [sound:german-das Bier.mp3]	beer
beginnen [sound:german-beginnen.mp3]	begin
der Anfang [sound:german-der Anfang.mp3]	beginning
das Benehmen [sound:german-das Benehmen.mp3]	behavior
hinter [sound:german-hinter.mp3]	behind
der Glauben [sound:german-der Glauben.mp3]	belief
glauben [sound:german-glauben.mp3]	believe
die Klingel [sound:german-die Klingel.mp3]	bell (door)
unter [sound:german-unter.mp3]	below
der Gurt [sound:german-der Gurt.mp3]	belt
der Nutzen [sound:german-der Nutzen.mp3]	benefit
neben [sound:german-neben.mp3]	beside
ausserdem [sound:german-ausserdem.mp3]	besides
die Wette [sound:german-die Wette.mp3]	bet
besser [sound:german-besser.mp3]	better
zwischen [sound:german-zwischen.mp3]	between
das Getränk [sound:german-das Getränk.mp3]	beverage
jenseits [sound:german-jenseits.mp3]	beyond
die Bibel [sound:german-die Bibel.mp3]	bible
das Fahrrad [sound:german-das Fahrrad.mp3]	bicycle
groß [sound:german-gross.mp3]	big
die Rechnung [sound:german-die Rechnung.mp3]	bill (noun)
der Vogel [sound:german-der Vogel.mp3]	bird
die Geburt [sound:german-die Geburt.mp3]	birth
der Geburtstag [sound:german-der Geburtstag.mp3]	birthday
das Biscuit [sound:german-das Biscuit.mp3]	biscuit
die Stück [sound:german-die Stück.mp3]	bit
bitter [sound:german-bitter.mp3]	bitter
schwarz [sound:german-schwarz.mp3]	black
die Decke [sound:german-die Decke.mp3]	blanket
blind [sound:german-blind.mp3]	blind
der Block [sound:german-der Block.mp3]	block
das Blut [sound:german-das Blut.mp3]	blood
die Bluse [sound:german-die Bluse.mp3]	blouse
blau [sound:german-blau.mp3]	blue
die Brett [sound:german-die Brett.mp3]	board
das Boot [sound:german-das Boot.mp3]	boat
der Körper [sound:german-der Körper.mp3]	body
kochen [sound:german-kochen.mp3]	boil
der Knochen [sound:german-der Knochen.mp3]	bone
das Buch [sound:german-das Buch.mp3]	book
die Buchhandlung [sound:german-die Buchhandlung.mp3]	bookshop
langweilg [sound:german-langweilg.mp3]	boring
beide [sound:german-beide.mp3]	both
die Flasche [sound:german-die Flasche.mp3]	bottle
der Boden [sound:german-der Boden.mp3]	bottom
die Schale [sound:german-die Schale.mp3]	bowl
die Schachtel [sound:german-die Schachtel.mp3]	box
der Junge [sound:german-der Junge.mp3]	boy
das Gehirn [sound:german-das Gehirn.mp3]	brain
die Bremse [sound:german-die Bremse.mp3]	brake
das Brot [sound:german-das Brot.mp3]	bread
brechen [sound:german-brechen.mp3]	break
das Frühstück [sound:german-das Frühstück.mp3]	breakfast
die Brust [sound:german-die Brust.mp3]	breast
der Atem [sound:german-der Atem.mp3]	breath
die Brücke [sound:german-die Brücke.mp3]	bridge
kurz [sound:german-kurz.mp3]	brief
hell [sound:german-hell.mp3]	bright / light
strahlend [sound:german-strahlend.mp3]	brilliant
bringen [sound:german-bringen.mp3]	bring
breit [sound:german-breit.mp3]	broad
pleite [sound:german-pleite.mp3]	broke
der Besen [sound:german-der Besen.mp3]	broom
der Bruder [sound:german-der Bruder.mp3]	brother
braun [sound:german-braun.mp3]	brown
die Bürste [sound:german-die Bürste.mp3]	brush
die Budget [sound:german-die Budget.mp3]	budget
bauen [sound:german-bauen.mp3]	to build
das Gebäude [sound:german-das Gebäude.mp3]	building
brennen [sound:german-brennen.mp3]	burn
die Verbrennung [sound:german-die Verbrennung.mp3]	burning
der Bus [sound:german-der Bus.mp3]	bus
das Geschäft [sound:german-das Geschäft.mp3]	business
beschäftigt [sound:german-beschäftigt.mp3]	busy
aber [sound:german-aber.mp3]	but
der Metzger [sound:german-der Metzger.mp3]	butcher
die Butter [sound:german-die Butter.mp3]	butter
der Schmetterling [sound:german-der Schmetterling.mp3]	butterfly
der Knopf [sound:german-der Knopf.mp3]	button
kaufen [sound:german-kaufen.mp3]	buy
durch, von [sound:german-durch, von.mp3]	by (a person)
zufällig [sound:german-zufällig.mp3]	by chance
auswendig [sound:german-auswendig.mp3]	by heart
übrigens [sound:german-übrigens.mp3]	by the way
der Gewinn [sound:german-der Gewinn.mp3]	gain
das Spiel [sound:german-das Spiel.mp3]	game
der Garten (nur Singular) [sound:german-der Garten.mp3]	garden
das Gas [sound:german-das Gas.mp3]	gas
das Benzin [sound:german-das Benzin.mp3]	gasoline
allgemein [sound:german-allgemein.mp3]	general
bekommen [sound:german-bekommen.mp3]	get
das Mädchen [sound:german-das Mädchen.mp3]	girl
geben [sound:german-geben.mp3]	give
fröhlich, dieroh [sound:german-fröhlich, dieroh.mp3]	glad
gerne [sound:german-gerne.mp3]	gladly
das Glas [sound:german-das Glas.mp3]	glass
die Brille [sound:german-die Brille.mp3]	glasses
gehen [sound:german-gehen.mp3]	go
das Gott [sound:german-das Gott.mp3]	God
das Gold [sound:german-das Gold.mp3]	gold
der Goldfisch [sound:german-der Goldfisch.mp3]	goldfish
gut [sound:german-gut.mp3]	good
auf Wiedersehen [sound:german-auf Wiedersehen.mp3]	good-bye
die Waren (nur plural) [sound:german-die Waren.mp3]	goods
die Gans [sound:german-die Gans.mp3]	goose
die Regierung [sound:german-die Regierung.mp3]	government
allmählich [sound:german-allmählich.mp3]	gradually
der Grossvater [sound:german-der Grossvater.mp3]	grandfather
die Grossmutter [sound:german-die Grossmutter.mp3]	grandmother
das Gras [sound:german-das Gras.mp3]	grass
grau [sound:german-grau.mp3]	gray
grün [sound:german-grün.mp3]	green
Wünsche, pl [sound:german-Wünsche, pl.mp3]	greetings
die Gruppe [sound:german-die Gruppe.mp3]	group
wachsen [sound:german-wachsen.mp3]	grow
vermuten [sound:german-vermuten.mp3]	guess
der Gast [sound:german-der Gast.mp3]	guest
das Gewehr [sound:german-das Gewehr.mp3]	gun
der Kerl [sound:german-der Kerl.mp3]	guy
die Haare [sound:german-Haare.mp3]	hair
halb [sound:german-halb.mp3]	half
die Halle [sound:german-die Halle.mp3]	hall
der Schinken [sound:german-der Schinken.mp3]	ham
der Hammer [sound:german-der Hammer.mp3]	hammer
der Hamster [sound:german-der Hamster.mp3]	hamster
die Hand [sound:german-die Hand.mp3]	hand
die Handtasche [sound:german-die Handtasche.mp3]	handbag
das Taschentuch [sound:german-das Taschentuch.mp3]	handkerchief
umgehen mit [sound:german-umgehen mit.mp3]	handle
hängen [sound:german-hängen.mp3]	hang
geschehen [sound:german-geschehen.mp3]	happen
glücklich [sound:german-glücklich.mp3]	happy
hard [sound:german-hard.mp3]	hard
kaum [sound:german-kaum.mp3]	hardly
die Ernte [sound:german-die Ernte.mp3]	harvest
der Hut [sound:german-der Hut.mp3]	hat
hassen [sound:german-hassen.mp3]	hate
haben [sound:german-haben.mp3]	have
er [sound:german-er.mp3]	he
der Kopf [sound:german-der Kopf.mp3]	head
die Gesundheit [sound:german-die Gesundheit.mp3]	health
gesund [sound:german-gesund.mp3]	healthy
hören [sound:german-hören.mp3]	hear
das Herz [sound:german-das Herz.mp3]	heart
die Hitze [sound:german-die Hitze.mp3]	heat
schwer [sound:german-schwer.mp3]	heavy
die Hölle [sound:german-die Hölle.mp3]	hell
Hilfe [sound:german-Hilfe.mp3]	help (noun)
helfen [sound:german-helfen.mp3]	to help
das Huhn [sound:german-das Huhn.mp3]	hen
hier [sound:german-hier.mp3]	here
der Held [sound:german-der Held.mp3]	hero
hoch [sound:german-hoch.mp3]	high
die Landstrasse [sound:german-die Landstrasse.mp3]	highway
der Hügel [sound:german-der Hügel.mp3]	hill
ihn, sie, es [sound:german-ihn, sie, es.mp3]	him, her, it
die Geschichte [sound:german-die Geschichte.mp3]	history
halten [sound:german-halten.mp3]	hold
das Loch [sound:german-das Loch.mp3]	hole
Ferien, pl [sound:german-Ferien, pl.mp3]	holiday
zuhause [sound:german-zuhause.mp3]	home, at home
die Ehre [sound:german-die Ehre.mp3]	honor
die Hoffnung [sound:german-die Hoffnung.mp3]	hope
schrecklich [sound:german-schrecklich.mp3]	horrible
das Pferd [sound:german-das Pferd.mp3]	horse
das Spital [sound:german-das Spital.mp3]	hospital
heiss [sound:german-heiss.mp3]	hot
das Hotel [sound:german-das Hotel.mp3]	hotel, inn
die Stunde [sound:german-die Stunde.mp3]	hour
das Haus [sound:german-das Haus.mp3]	house
wie auch immer [sound:german-wie auch immer.mp3]	however
riesig [sound:german-riesig.mp3]	huge
menschlich [sound:german-menschlich.mp3]	human (adj)
hundert [sound:german-hundert.mp3]	hundred
hungrig [sound:german-hungrig.mp3]	hungry
sich beeilen [sound:german-sich beeilen.mp3]	hurry
verletzen [sound:german-verletzen.mp3]	hurt, injure
der Ehemann [sound:german-der Ehemann.mp3]	husband
ich [sound:german-ich.mp3]	I
das Eis [sound:german-das Eis.mp3]	ice
Eiskrem, Eis [sound:german-Eiskrem, Eis.mp3]	ice cream
die Idee [sound:german-die Idee.mp3]	idea
ideal [sound:german-ideal.mp3]	ideal
wenn [sound:german-wenn.mp3]	if
das Bild [sound:german-das Bild.mp3]	image
sich vorstellen [sound:german-sich vorstellen.mp3]	imagine
sofort [sound:german-sofort.mp3]	immediately
der Einfluss [sound:german-der Einfluss.mp3]	impact
wichtig [sound:german-wichtig.mp3]	important
unmöglich [sound:german-unmöglich.mp3]	impossible
verbessern [sound:german-verbessern.mp3]	improve
in [sound:german-in.mp3]	in
trotz [sound:german-trotz.mp3]	in spite of
der Zoll [sound:german-der Zoll.mp3]	inch
beinhalten [sound:german-beinhalten.mp3]	include
zunehmen [sound:german-zunehmen.mp3]	increase
unabhängig [sound:german-unabhängig.mp3]	independent
Inhaltsverzeichnis [sound:german-Inhaltsverzeichnis.mp3]	index
Zeigefinger [sound:german-Zeigefinger.mp3]	index finger
anfänglich [sound:german-anfänglich.mp3]	initial
das Insekt [sound:german-das Insekt.mp3]	insect
drinnen [sound:german-drinnen.mp3]	inside
anstatt [sound:german-anstatt.mp3]	instead
Interesse [sound:german-Interesse.mp3]	interest
interessant [sound:german-interessant.mp3]	interesting
die Innere [sound:german-die Innere.mp3]	interior
einladen [sound:german-einladen.mp3]	invite
verwickeln [sound:german-verwickeln.mp3]	involve
das Eisen [sound:german-das Eisen.mp3]	iron
die Insel [sound:german-die Insel.mp3]	island
das Problem [sound:german-das Problem.mp3]	issue
es [sound:german-es.mp3]	it
es ist kalt [sound:german-es ist kalt.mp3]	it's cold
es ist neblig [sound:german-es ist neblig.mp3]	it's foggy
es friert Kälte ein [sound:german-es friert Kälte ein.mp3]	it's freezing
es ist nett [sound:german-es ist nett.mp3]	it's nice
es ist regnerisch [sound:german-es ist regnerisch.mp3]	it's rainy
es ist schneebedeckt [sound:german-es ist schneebedeckt.mp3]	it's snowy
es ist sonnig [sound:german-es ist sonnig.mp3]	it's sunny
es ist windig [sound:german-es ist windig.mp3]	it's windy
die Jacke [sound:german-die Jacke.mp3]	jacket
die Marmelade [sound:german-die Marmelade.mp3]	jam
der Januar [sound:german-der Januar.mp3]	January
der Job [sound:german-der Job.mp3]	job
sich anschliessen [sound:german-sich anschliessen.mp3]	join
der Richter [sound:german-der Richter.mp3]	judge
der Saft [sound:german-der Saft.mp3]	juice
der Juli [sound:german-der Juli.mp3]	July
springen [sound:german-springen.mp3]	jump
der Juni [sound:german-der Juni.mp3]	June
nur [sound:german-nur.mp3]	just (only)
die Gerechtigkeit [sound:german-die Gerechtigkeit.mp3]	justice
der Schlüssel [sound:german-der Schlüssel.mp3]	key
töten [sound:german-töten.mp3]	kill
die Art [sound:german-die Art.mp3]	kind
der König [sound:german-der König.mp3]	king
der Kuss [sound:german-der Kuss.mp3]	kiss
die Küche [sound:german-die Küche.mp3]	kitchen
das Kätzchen [sound:german-das Kätzchen.mp3]	kitten
das Knie [sound:german-das Knie.mp3]	knee
das Messer, die Messer [sound:german-das Messer.mp3]	knife
kennen [sound:german-kennen.mp3]	know (person)
können [sound:german-können.mp3]	know to
das Wissen [sound:german-das Wissen.mp3]	knowledge
die Arbeit [sound:german-die Arbeit.mp3]	labor
mangeln [sound:german-mangeln.mp3]	lack
die Leiter, - [sound:german-die Leiter.mp3]	ladder
die Dame [sound:german-die Dame.mp3]	lady
der See [sound:german-der See.mp3]	lake
die Lampe [sound:german-die Lampe.mp3]	lamp
das Land [sound:german-das Land.mp3]	land
die Sprache [sound:german-die Sprache.mp3]	language
letzte [sound:german-letzte.mp3]	last (previous)
spät [sound:german-spät.mp3]	late
lachen [sound:german-lachen.mp3]	to laugh
das Recht [sound:german-das Recht.mp3]	law
legen [sound:german-legen.mp3]	to lay, to place, to put
führen [sound:german-führen.mp3]	lead
Anführer, d [sound:german-Anführer, d.mp3]	leader
lernen [sound:german-lernen.mp3]	to learn
weggehen [sound:german-weggehen.mp3]	leave
links [sound:german-links.mp3]	left
das Bein [sound:german-das Bein.mp3]	leg
gesetzlich [sound:german-gesetzlich.mp3]	legal
die Zitrone [sound:german-die Zitrone.mp3]	lemon
die Länge [sound:german-die Länge.mp3]	length
weniger [sound:german-weniger.mp3]	less
lassen [sound:german-lassen.mp3]	let (allow)
der Brief [sound:german-der Brief.mp3]	letter
die Bibliothek [sound:german-die Bibliothek.mp3]	library
liegen [sound:german-liegen.mp3]	lie
lügen [sound:german-lügen.mp3]	lie
die Leben [sound:german-die Leben.mp3]	life
heben [sound:german-heben.mp3]	lift (verb)
leicht [sound:german-leicht.mp3]	light (adjective)
Licht [sound:german-Licht.mp3]	light (electr)
der Blitz [sound:german-der Blitz.mp3]	lightning
mögen [sound:german-mögen.mp3]	like (verb)
wahrscheinlich [sound:german-wahrscheinlich.mp3]	likely
die Linie [sound:german-die Linie.mp3]	line
die Lippe [sound:german-die Lippe.mp3]	lip
flüssig [sound:german-flüssig.mp3]	liquid
die Liste [sound:german-die Liste.mp3]	list
hören, zuhören [sound:german-hören, zuhören.mp3]	listen
die Literatur [sound:german-die Literatur.mp3]	literature
wenig [sound:german-wenig.mp3]	little (amount)
klein [sound:german-klein.mp3]	little (size)
leben [sound:german-leben.mp3]	live
wohnen [sound:german-wohnen.mp3]	live, dwell
lokal [sound:german-lokal.mp3]	local
gelegen [sound:german-gelegen.mp3]	located
der Standort [sound:german-der Standort.mp3]	location
das Schloss [sound:german-das Schloss.mp3]	lock (noun)
lang [sound:german-lang.mp3]	long (object)
lange [sound:german-lange.mp3]	long (time)
schauen [sound:german-schauen.mp3]	look
verlieren [sound:german-verlieren.mp3]	lose
der Verlust [sound:german-der Verlust.mp3]	loss
der Haufen [sound:german-der Haufen.mp3]	lot / pile
laut [sound:german-laut.mp3]	loud
die Liebe [sound:german-die Liebe.mp3]	love (noun)
lieben [sound:german-lieben.mp3]	to love&nbsp;
leise [sound:german-leise.mp3]	low
das Glück [sound:german-das Glück.mp3]	luck
das Mittagessen [sound:german-das Mittagessen.mp3]	lunch
die Maschine [sound:german-die Maschine.mp3]	machine
das Magazin [sound:german-das Magazin.mp3]	magazine
die Post [sound:german-die Post.mp3]	mail
instandhalten [sound:german-instandhalten.mp3]	maintain
die Mehrheit [sound:german-die Mehrheit.mp3]	majority
machen [sound:german-machen.mp3]	to make
der Mann / der derensch [sound:german-der Mann / der derensch.mp3]	man
viele [sound:german-viele.mp3]	many
die Landkarte [sound:german-die Landkarte.mp3]	map
der März [sound:german-der März.mp3]	March
marschieren [sound:german-marschieren.mp3]	march
kennzeichnen [sound:german-kennzeichnen.mp3]	mark
der Markt [sound:german-der Markt.mp3]	market
die Hochzeit [sound:german-die Hochzeit.mp3]	marriage
verheiratet [sound:german-verheiratet.mp3]	married
die Messe [sound:german-die Messe.mp3]	mass
das Material [sound:german-das Material.mp3]	material
der Gegenstand [sound:german-der Gegenstand.mp3]	matter
das Maximum [sound:german-das Maximum.mp3]	maximum
der Mai [sound:german-der Mai.mp3]	May
dürfen [sound:german-dürfen.mp3]	may
vielleicht [sound:german-vielleicht.mp3]	maybe
die Wiese [sound:german-die Wiese.mp3]	meadow
die Mahlzeit [sound:german-die Mahlzeit.mp3]	meal
meinen, denken [sound:german-meinen, denken.mp3]	mean
die Bedeutung [sound:german-die Bedeutung.mp3]	meaning
das Mittel [sound:german-das Mittel.mp3]	means
unterdessen [sound:german-unterdessen.mp3]	meanwhile
das Maß(e) [sound:german-das Mass.mp3]	measure (noun)
das Fleisch [sound:german-das Fleisch.mp3]	meat
treffen [sound:german-treffen.mp3]	to meet
das Mitglied [sound:german-das Mitglied.mp3]	member
das Gedächtnis [sound:german-das Gedächtnis.mp3]	memory
erwähnen [sound:german-erwähnen.mp3]	mention
die Botschaft [sound:german-die Botschaft.mp3]	message
das Metall [sound:german-das Metall.mp3]	metal
die Methode [sound:german-die Methode.mp3]	method
Mittag [sound:german-Mittag.mp3]	midday, dasoon
Mitternacht [sound:german-Mitternacht.mp3]	midnight
die Meile [sound:german-die Meile.mp3]	mile
die Milch [sound:german-die Milch.mp3]	milk
die Million [sound:german-die Million.mp3]	million
der Sinn / der Geist [sound:german-der Sinn.mp3]&nbsp;<span style=" font-style: normal; font-weight: normal;">[sound:german-der Geist.mp3]</span>	mind
das Minimum [sound:german-das Minimum.mp3]	minimum
der Minister [sound:german-der Minister.mp3]	minister
die Minute [sound:german-die Minute.mp3]	minute
der Spiegel [sound:german-der Spiegel.mp3]	mirror
Fräulein [sound:german-Fräulein.mp3]	Miss
vermissen [sound:german-vermissen.mp3]	miss (verb)
der Fehler [sound:german-der Fehler.mp3]	mistake
modern [sound:german-modern.mp3]	modern
der Augenblick / der deroment [sound:german-der Augenblick / der deroment.mp3]	moment
der Montag [sound:german-der Montag.mp3]	Monday
das Geld [sound:german-das Geld.mp3]	money
der Monat [sound:german-der Monat.mp3]	month
der Mond [sound:german-der Mond.mp3]	moon
mehr [sound:german-mehr.mp3]	more
der Morgen [sound:german-der Morgen.mp3]	morning
die meisten [sound:german-die meisten.mp3]	most
die Mutter [sound:german-die Mutter.mp3]	mother
die Bewegung [sound:german-die Bewegung.mp3]	motion
der Motor [sound:german-der Motor.mp3]	motor
der Berg [sound:german-der Berg.mp3]	mountain
die Maus [sound:german-die Maus.mp3]	mouse
der Mund [sound:german-der Mund.mp3]	mouth
bewegen [sound:german-bewegen.mp3]	move
Herr [sound:german-Herr.mp3]	Mr.
Frau [sound:german-Frau.mp3]	Mrs.
viel [sound:german-viel.mp3]	much
der Mord [sound:german-der Mord.mp3]	murder
die Musik [sound:german-die Musik.mp3]	music
müssen [sound:german-müssen.mp3]	must
mich [sound:german-mich.mp3]	myself
der Nagel [sound:german-der Nagel.mp3]	nail
der Name [sound:german-der Name.mp3]	name
die Serviette [sound:german-die Serviette.mp3]	napkin
eng [sound:german-eng.mp3]	narrow
böse, schlimm [sound:german-böse, schlimm.mp3]	nasty
natürlich [sound:german-natürlich.mp3]	natural
die Natur [sound:german-die Natur.mp3]	nature
nahe [sound:german-nahe.mp3]	near
notwendig [sound:german-notwendig.mp3]	necessary
der Hals [sound:german-der Hals.mp3]	neck
brauchen [sound:german-brauchen.mp3]	need
die Nadel [sound:german-die Nadel.mp3]	needle
der Nachbar [sound:german-der Nachbar.mp3]	neighbor
die Nachbarschaft [sound:german-die Nachbarschaft.mp3]	neighborhood
nie [sound:german-nie.mp3]	never
trotzdem [sound:german-trotzdem.mp3]	nevertheless
neu [sound:german-neu.mp3]	new
Nachrichten (nur Plural) [sound:german-die Nachrichten.mp3]	news
die Zeitung [sound:german-die Zeitung.mp3]	newspaper
das Gesicht [sound:german-das Gesicht.mp3]	face
Möglichkeiten [sound:german-Möglichkeiten.mp3]	facilities
die Tatsache [sound:german-die Tatsache.mp3]	fact
der Faktor [sound:german-der Faktor.mp3]	factor
die Fabrik [sound:german-die Fabrik.mp3]	factory
fehlschlagen [sound:german-fehlschlagen.mp3]	fail
das Versagen [sound:german-das Versagen.mp3]	failure
ehrlich [sound:german-ehrlich.mp3]	fair
eher [sound:german-eher.mp3]	fairly
das Märchen [sound:german-das Märchen.mp3]	fairy tale
fallen [sound:german-fallen.mp3]	fall
falsch [sound:german-falsch.mp3]	false,
gewohnt, vertraut [sound:german-gewohnt, vertraut.mp3]	familiar
die Familie [sound:german-die Familie.mp3]	family
weit [sound:german-weit.mp3]	far
der Bauernhof [sound:german-der Bauernhof.mp3]	farm
die Mode [sound:german-die Mode.mp3]	fashion
schnell [sound:german-schnell.mp3]	fast
fett [sound:german-fett.mp3]	fat
der Vater [sound:german-der Vater.mp3]	father
der Gefallen [sound:german-der Gefallen.mp3]	favor
die Angst [sound:german-die Angst.mp3]	fear
Eigenschaften [sound:german-Eigenschaften.mp3]	features
der Februar [sound:german-der Februar.mp3]	February
ernähren, dieüttern [sound:german-ernähren, dieüttern.mp3]	feed
sich fühlen [sound:german-sich fühlen.mp3]	feel (good)
das Gefühl [sound:german-das Gefühl.mp3]	feeling
beglückwünschen [sound:german-beglückwünschen.mp3]	felicitate
weiblich [sound:german-weiblich.mp3]	female
holen [sound:german-holen.mp3]	fetch
das Feld [sound:german-das Feld.mp3]	field
fünfzehn [sound:german-fünfzehn.mp3]	fifteen
fünfzig [sound:german-fünfzig.mp3]	fifty
die Feige [sound:german-die Feige.mp3]	fig
der Kampf [sound:german-der Kampf.mp3]	fight
herausfinden [sound:german-herausfinden.mp3]	figure out
die Akte [sound:german-die Akte.mp3]	file
füllen [sound:german-füllen.mp3]	fill
der Film [sound:german-der Film.mp3]	film
finden [sound:german-finden.mp3]	find
fein, schön [sound:german-fein, schön.mp3]	fine
der Finger [sound:german-der Finger.mp3]	finger
beenden [sound:german-beenden.mp3]	finish (verb)
das Feuer [sound:german-das Feuer.mp3]	fire (noun)
der Fisch [sound:german-der Fisch.mp3]	fish
fünf [sound:german-fünf.mp3]	five
Wohnung [sound:german-Wohnung.mp3]	flat
flach [sound:german-flach.mp3]	flat (adj.)
Fleisch [sound:german-Fleisch.mp3]	flesh (body)
das Mehl [sound:german-das Mehl.mp3]	flour
fliessen [sound:german-fliessen.mp3]	flow
die Blume [sound:german-die Blume.mp3]	flower
die Fliege [sound:german-die Fliege.mp3]	fly (insect)
fliegen [sound:german-fliegen.mp3]	fly (verb)
folgen [sound:german-folgen.mp3]	to follow
die Nahrung / das Essen [sound:german-die Nahrung / das Essen.mp3]	food
der Fuss [sound:german-der Fuss.mp3]	foot
für [sound:german-für.mp3]	for
verboten [sound:german-verboten.mp3]	forbidden
die Kraft [sound:german-die Kraft.mp3]	force
fremd, ausländisch [sound:german-fremd, ausländisch.mp3]	foreign
der Wald [sound:german-der Wald.mp3]	forest
vergessen [sound:german-vergessen.mp3]	forget
vergeben [sound:german-vergeben.mp3]	forgive
die Gabel [sound:german-die Gabel.mp3]	fork
die Form [sound:german-die Form.mp3]	form
früherer [sound:german-früherer.mp3]	former
vierzig [sound:german-vierzig.mp3]	forty
der Brunnen [sound:german-der Brunnen.mp3]	fountain
vier [sound:german-vier.mp3]	four
vierzehn [sound:german-vierzehn.mp3]	fourteen
der Fuchs [sound:german-der Fuchs.mp3]	fox
der Rahmen [sound:german-der Rahmen.mp3]	frame
gratis [sound:german-gratis.mp3]	free
frei [sound:german-frei.mp3]	free (not occupied)
häufig [sound:german-häufig.mp3]	frequently
frisch [sound:german-frisch.mp3]	fresh
der Freitag [sound:german-der Freitag.mp3]	Friday
der Freund / die diereundin [sound:german-der Freund / die diereundin.mp3]	friend
freundlich [sound:german-freundlich.mp3]	friendly
erschrecken [sound:german-erschrecken.mp3]	frighten
von [sound:german-von.mp3]	from
die Vorderseite [sound:german-die Vorderseite.mp3]	front
voll [sound:german-voll.mp3]	full
lustig [sound:german-lustig.mp3]	funny
die Möbel (nur Plural) [sound:german-die Möbel.mp3]	furniture
die Zukunft [sound:german-die Zukunft.mp3]	future
die Seite [sound:german-die Seite.mp3]	page
der Schmerz [sound:german-der Schmerz.mp3]	pain
das Gemälde [sound:german-das Gemälde.mp3]	painting
das Paar [sound:german-das Paar.mp3]	pair
bleich [sound:german-Bleich.mp3]	pale (adj)
das Papier [sound:german-das Papier.mp3]	paper
Eltern, pl [sound:german-Eltern, pl.mp3]	parents
der Park [sound:german-der Park.mp3]	park
Parkieren [sound:german-Parkieren.mp3]	parking
der Teil [sound:german-der Teil.mp3]	part
Besonders [sound:german-Besonders.mp3]	particular
teilweise [sound:german-teilweise.mp3]	partly
die Party [sound:german-die Party.mp3]	party
der Pass [sound:german-der Pass.mp3]	passport
die Vergangenheit [sound:german-die Vergangenheit.mp3]	past
geduldig [sound:german-geduldig.mp3]	patient
das Muster [sound:german-das Muster.mp3]	pattern
zahlen [sound:german-zahlen.mp3]	pay
die Zahlung [sound:german-die Zahlung.mp3]	payment
die Erbe [sound:german-die Erbe.mp3]	pea
der Frieden [sound:german-der Frieden.mp3]	peace
die Birne [sound:german-die Birne.mp3]	pear
der Kugelschreiber [sound:german-der Kugelschreiber.mp3]	pen
die Leute (pl) [sound:german-die Leute.mp3]	people
Leistung,Vorstellung, die [sound:german-Leistung,Vorstellung, die.mp3]	performance
Punkt(Zeichen), der [sound:german-Punkt(Zeichen), der.mp3]	period
die Person [sound:german-die Person.mp3]	person
persönlich [sound:german-persönlich.mp3]	personal
pflücken [sound:german-pflücken.mp3]	pick
das Stück [sound:german-das Stück.mp3]	piece
das Schwein [sound:german-das Schwein.mp3]	pig
der Ort / die Stelle [sound:german-der Ort / die Stelle.mp3]	place, spot
der Plan [sound:german-der Plan.mp3]	plan
die Pflanze [sound:german-die Pflanze.mp3]	plant
der Teller [sound:german-der Teller.mp3]	plate
spielen [sound:german-spielen.mp3]	play
angenehm [sound:german-angenehm.mp3]	pleasant
bitte [sound:german-bitte.mp3]	please
das Vergnügen [sound:german-das Vergnügen.mp3]	pleasure
sehr viel [sound:german-sehr viel.mp3]	plenty
der Punkt [sound:german-der Punkt.mp3]	point
die Polizei [sound:german-die Polizei.mp3]	police
das Schwimmbecken [sound:german-das Schwimmbecken.mp3]	pool
arm [sound:german-arm.mp3]	poor
beliebt [sound:german-beliebt.mp3]	popular
die Bevölkerung [sound:german-die Bevölkerung.mp3]	population
das Schweinefleisch [sound:german-das Schweinefleisch.mp3]	pork
die Lage [sound:german-die Lage.mp3]	position
möglich [sound:german-möglich.mp3]	possible
das Postbüro [sound:german-das Postbüro.mp3]	post office
die Postkarte [sound:german-die Postkarte.mp3]	postcard
der Topf [sound:german-der Topf.mp3]	pot
die Kartoffel [sound:german-die Kartoffel.mp3]	potato
Macht, die,Kraft, die [sound:german-Macht, die,Kraft, die.mp3]	power
mächtig [sound:german-mächtig.mp3]	powerful
die Uebung [sound:german-die Uebung.mp3]	practice
beten, bitten [sound:german-beten, bitten.mp3]	pray
vorbereiten [sound:german-vorbereiten.mp3]	prepare
das Geschenk [sound:german-das Geschenk.mp3]	present
der Präsident [sound:german-der Präsident.mp3]	president
der Druck [sound:german-der Druck.mp3]	pressure
hübsch [sound:german-hübsch.mp3]	pretty
vorbeugen [sound:german-vorbeugen.mp3]	prevent
der Preis [sound:german-der Preis.mp3]	price
das Produkt [sound:german-das Produkt.mp3]	product
das Programm [sound:german-das Programm.mp3]	program
der Fortschritt [sound:german-der Fortschritt.mp3]	progress
versprechen [sound:german-versprechen.mp3]	promise
das Eigentum [sound:german-das Eigentum.mp3]	property
Vorschlag [sound:german-Vorschlag.mp3]	proposal
vorschlagen [sound:german-vorschlagen.mp3]	to propose
der Schutz [sound:german-der Schutz.mp3]	protection
stolz [sound:german-stolz.mp3]	proud
beweisen [sound:german-beweisen.mp3]	prove
liefern [sound:german-liefern.mp3]	provide
die Zwetschge [sound:german-die Zwetschge.mp3]	prune
öffentlich [sound:german-öffentlich.mp3]	public
veröffentlichen [sound:german-veröffentlichen.mp3]	publish
ziehen [sound:german-ziehen.mp3]	pull
rein [sound:german-rein.mp3]	pure
purpurfarbig [sound:german-purpurfarbig.mp3]	purple
der Zweck [sound:german-der Zweck.mp3]	purpose
stossen [sound:german-stossen.mp3]	push
legen, stellen [sound:german-legen, stellen.mp3]	to put
die Qualität [sound:german-die Qualität.mp3]	quality
die Königin [sound:german-die Königin.mp3]	queen
die Frage [sound:german-die Frage.mp3]	question
ruhig [sound:german-ruhig.mp3]	quiet
ganz [sound:german-ganz.mp3]	quite
das Kaninchen [sound:german-das Kaninchen.mp3]	rabbit
die Rasse [sound:german-die Rasse.mp3]	race
das Radio [sound:german-das Radio.mp3]	radio
die Eisenbahn [sound:german-die Eisenbahn.mp3]	railroad
der Regen [sound:german-der Regen.mp3]	rain
regnen [sound:german-regnen.mp3]	rain (verb)
aufziehen [sound:german-aufziehen.mp3]	raise
der Bereich [sound:german-der Bereich.mp3]	range
selten [sound:german-selten.mp3]	rare
der Kurs [sound:german-der Kurs.mp3]	rate (noun)
roh [sound:german-roh.mp3]	raw
lesen [sound:german-lesen.mp3]	read
bereit [sound:german-bereit.mp3]	ready
wirklich [sound:german-wirklich.mp3]	real
die Wirklichkeit [sound:german-die Wirklichkeit.mp3]	reality
erkennen,ausführen [sound:german-erkennen,ausführen.mp3]	realize
die Hinterseite [sound:german-die Hinterseite.mp3]	rear
der Grund [sound:german-der Grund.mp3]	reason
vernünftig [sound:german-vernünftig.mp3]	reasonable
erhalten, bekommen [sound:german-erhalten, bekommen.mp3]	receive
kürzlich [sound:german-kürzlich.mp3]	recently
erkennen [sound:german-erkennen.mp3]	recognize
die Schallplatte [sound:german-die Schallplatte.mp3]	record
sich erholen [sound:german-sich erholen.mp3]	recover
rot [sound:german-rot.mp3]	red
verringern [sound:german-verringern.mp3]	reduce
der Kühlschrank [sound:german-der Kühlschrank.mp3]	refrigerator
ablehnen [sound:german-ablehnen.mp3]	refuse
der Hinblick [sound:german-der Hinblick.mp3]	regard
Gegend [sound:german-Gegend.mp3]	region
regelmässig, üblich [sound:german-regelmässig, üblich.mp3]	regular
das Verhältnis [sound:german-das Verhältnis.mp3]	relation
verhältnismässig [sound:german-verhältnismässig.mp3]	relatively
die Erleichterung [sound:german-die Erleichterung.mp3]	relief
die Religion [sound:german-die Religion.mp3]	religion
zurückbleiben [sound:german-zurückbleiben.mp3]	remain
die Bemerkung [sound:german-die Bemerkung.mp3]	remark
sich erinnern [sound:german-sich erinnern.mp3]	remember
entfernen [sound:german-entfernen.mp3]	remove
wiederholen [sound:german-wiederholen.mp3]	to repeat
antworten [sound:german-antworten.mp3]	reply
berichten [sound:german-berichten.mp3]	report
darstellen [sound:german-darstellen.mp3]	represent
erfordern [sound:german-erfordern.mp3]	require
Forschen [sound:german-Forschen.mp3]	research (do ~)
die Forschung [sound:german-die Forschung.mp3]	research (noun)
verantwortlich [sound:german-verantwortlich.mp3]	responsible
sich ausruhen [sound:german-sich ausruhen.mp3]	rest
das Restaurant [sound:german-das Restaurant.mp3]	restaurant
das Ergebnis [sound:german-das Ergebnis.mp3]	result
zurückkehren [sound:german-zurückkehren.mp3]	return
der Reis [sound:german-der Reis.mp3]	rice
reich [sound:german-reich.mp3]	rich
rechts [sound:german-rechts.mp3]	right (direction)
richtig [sound:german-rechtig.mp3]	right (fair)
läuten [sound:german-läuten.mp3]	ring
aufstehen [sound:german-aufstehen.mp3]	rise
das Risiko [sound:german-das Risiko.mp3]	risk
Fluss [sound:german-Fluss.mp3]	river
der Fels [sound:german-der Fels.mp3]	rock
die Rolle [sound:german-die Rolle.mp3]	role
das Dach [sound:german-das Dach.mp3]	roof
das Zimmer [sound:german-das Zimmer.mp3]	room
rund [sound:german-rund.mp3]	round
die Regel [sound:german-die Regel.mp3]	rule
laufen, rennen [sound:german-laufen, rennen.mp3]	run
traurig [sound:german-traurig.mp3]	sad
sicher [sound:german-sicher.mp3]	safe
der Salat [sound:german-der Salat.mp3]	salad
das Salz [sound:german-das Salz.mp3]	salt
die Probe [sound:german-die Probe.mp3]	sample
zufrieden [sound:german-zufrieden.mp3]	satisfied
der Samstag [sound:german-der Samstag.mp3]	Saturday
die Wurst [sound:german-die Wurst.mp3]	sausage
retten, sichern [sound:german-retten, sichern.mp3]	save
sagen [sound:german-sagen.mp3]	say
Szene [sound:german-Szene.mp3]	scene
die Schule [sound:german-die Schule.mp3]	school
die Wissenschaft [sound:german-die Wissenschaft.mp3]	science
die Schere [sound:german-die Schere.mp3]	scissors
die Schraube [sound:german-die Schraube.mp3]	screw
das Meer [sound:german-das Meer.mp3]	sea
suchen [sound:german-suchen.mp3]	search
die Jahreszeit [sound:german-die Jahreszeit.mp3]	season
der Sitz [sound:german-der Sitz.mp3]	seat
das Geheimnis [sound:german-das Geheimnis.mp3]	secret
die Sekretärin [sound:german-die Sekretärin.mp3]	secretary
sehen [sound:german-sehen.mp3]	see
scheinen [sound:german-scheinen.mp3]	seem
auswählen [sound:german-auswählen.mp3]	select
verkaufen [sound:german-verkaufen.mp3]	sell
senden, schicken [sound:german-senden, schicken.mp3]	send
der Sinn / das Gefühl [sound:german-der Sinn / das Gefühl.mp3]	sense
der September [sound:german-der September.mp3]	September
ernsthaft [sound:german-ernsthaft.mp3]	serious
dienen als [sound:german-dienen als.mp3]	serve as
der Dienst [sound:german-der Dienst.mp3]	service
abgemacht [sound:german-abgemacht.mp3]	settled
sieben [sound:german-sieben.mp3]	seven
siebzehn [sound:german-siebzehn.mp3]	seventeen
siebzig [sound:german-siebzig.mp3]	seventy
mehrere [sound:german-mehrere.mp3]	several
das Geschlecht [sound:german-das Geschlecht.mp3]	sex
sexuell [sound:german-sexuell.mp3]	sexual
der Schatten, - [sound:german-der Schatten.mp3]	shadow
sollen [sound:german-sollen.mp3]	shall
teilen [sound:german-teilen.mp3]	share
scharf [sound:german-scharf.mp3]	sharp
sich rasieren [sound:german-sich rasieren.mp3]	shave
sie [sound:german-sie.mp3]	she
das Schaf [sound:german-das Schaf.mp3]	sheep
das Obdach [sound:german-das Obdach.mp3]	shelter
das Schiff [sound:german-das Schiff.mp3]	ship
das Hemd [sound:german-das Hemd.mp3]	shirt
Schuhe, pl [sound:german-Schuhe, pl.mp3]	shoes
schiessen [sound:german-schiessen.mp3]	shoot
der Laden [sound:german-der Laden.mp3]	shop
Schuss [sound:german-Schuss.mp3]	shot
die Schulter [sound:german-die Schulter.mp3]	shoulder
zeigen [sound:german-zeigen.mp3]	show
krank [sound:german-krank.mp3]	sick, ill
das Zeichen [sound:german-das Zeichen.mp3]	sign (noun)
unterschreiben [sound:german-unterschreiben.mp3]	sign (verb)
das Signal [sound:german-das Signal.mp3]	signal
bedeuten [sound:german-bedeuten.mp3]	signify
die Ruhe [sound:german-die Ruhe.mp3]	silence
das Silber [sound:german-das Silber.mp3]	silver
gleich [sound:german-gleich.mp3]	similar
einfach [sound:german-einfach.mp3]	simple
die Sünde [sound:german-die Sünde.mp3]	sin
seit [sound:german-seit.mp3]	since
singen [sound:german-singen.mp3]	sing
die Schwester [sound:german-die Schwester.mp3]	sister
sich setzen [sound:german-sich setzen.mp3]	sit
sechs [sound:german-sechs.mp3]	six
sechzehn [sound:german-sechzehn.mp3]	sixteen
sechzig [sound:german-sechzig.mp3]	sixty
die Größe [sound:german-die Grösse.mp3]	size
die Haut [sound:german-die Haut.mp3]	skin
der Rock [sound:german-der Rock.mp3]	skirt
der Himmel [sound:german-der Himmel.mp3]	sky
schlafen [sound:german-schlafen.mp3]	sleep
geringfügig [sound:german-geringfügig.mp3]	slight
langsam [sound:german-langsam.mp3]	slow
riechen [sound:german-riechen.mp3]	smell
lächeln [sound:german-lächeln.mp3]	smile
der Schmied [sound:german-der Schmied.mp3]	smith
rauchen [sound:german-rauchen.mp3]	to smoke
weich, glatt [sound:german-weich, glatt.mp3]	smooth
die Schnecke [sound:german-die Schnecke.mp3]	snail
die Schlange(n) [sound:german-die Schlange.mp3]	snake
der Schnee [sound:german-der Schnee.mp3]	snow
so [sound:german-so.mp3]	so
die Seife [sound:german-die Seife.mp3]	soap
die Gesellschaft [sound:german-die Gesellschaft.mp3]	society
weich [sound:german-weich.mp3]	soft
Boden(Erde), der [sound:german-Boden(Erde), der.mp3]	soil
der Soldat [sound:german-der Soldat.mp3]	soldier
fest [sound:german-fest.mp3]	solid
die Lösung [sound:german-die Lösung.mp3]	solution
einige [sound:german-einige.mp3]	some (object)
jemand [sound:german-jemand.mp3]	somebody
manchmal [sound:german-manchmal.mp3]	sometimes
der Sohn [sound:german-der Sohn.mp3]	son
das Lied [sound:german-das Lied.mp3]	song
bald [sound:german-bald.mp3]	soon
der Klang [sound:german-der Klang.mp3]	sound
die Suppe [sound:german-die Suppe.mp3]	soup
sauer [sound:german-sauer.mp3]	sour
die Quelle [sound:german-die Quelle.mp3]	source
Süden [sound:german-Süden.mp3]	south
der Raum [sound:german-der Raum.mp3]	space
sprechen [sound:german-sprechen.mp3]	speak
die Geschwindigkeit [sound:german-die Geschwindigkeit.mp3]	speed
ausgeben [sound:german-ausgeben.mp3]	spend
der Stall [sound:german-der Stall.mp3]	spider
der Geist [sound:german-der Geist.mp3]	spirit
prächtig [sound:german-prächtig.mp3]	splendid
der Löffel [sound:german-der Löffel.mp3]	spoon
die Stelle / der Ort [sound:german-die Stelle / der Ort.mp3]	spot
ausbreiten [sound:german-ausbreiten.mp3]	spread
der Frühling [sound:german-der Frühling.mp3]	spring
der Platz [sound:german-der Platz.mp3]	square
das Personal [sound:german-das Personal.mp3]	staff
die Bühne [sound:german-die Bühne.mp3]	stage
die Treppe [sound:german-die Treppe.mp3]	stairs
die Briefmarke [sound:german-die Briefmarke.mp3]	stamp
stehen [sound:german-stehen.mp3]	stand
der Stern [sound:german-der Stern.mp3]	star
starren, blicken [sound:german-starren, blicken.mp3]	to stare
der Staat [sound:german-der Staat.mp3]	state
der Bahnhof [sound:german-der Bahnhof.mp3]	station
bleiben [sound:german-bleiben.mp3]	stay
der Stahl [sound:german-der Stahl.mp3]	steel
der Schritt [sound:german-der Schritt.mp3]	step
immer noch [sound:german-immer noch.mp3]	still
rühren [sound:german-rühren.mp3]	stir
die Aktie [sound:german-die Aktie.mp3]	stock
der Magen [sound:german-der Magen.mp3]	stomach
der Stein [sound:german-der Stein.mp3]	stone
die Haltestelle [sound:german-die Haltestelle.mp3]	stop
anhalten [sound:german-anhalten.mp3]	stop (verb)
der Sturm [sound:german-der Sturm.mp3]	storm
der Ofen [sound:german-der Ofen.mp3]	stove
geradeaus [sound:german-geradeaus.mp3]	straight
fremd, seltsam [sound:german-fremd, seltsam.mp3]	strange
die Erdbeere [sound:german-die Erdbeere.mp3]	strawberry
der Strom / der Fluss [sound:german-der Strom.mp3]&nbsp;<span style=" font-style: normal; font-weight: normal;">[sound:german-der Fluss.mp3]</span>	stream
Strasse [sound:german-Strasse.mp3]	street
Kraft, die , Stärke, die [sound:german-Kraft, die , Stärke, die.mp3]	strength
stark [sound:german-stark.mp3]	strong
streiten,kämpfen [sound:german-streiten,kämpfen.mp3]	struggle
studieren [sound:german-studieren.mp3]	study
der Erfolg [sound:german-der Erfolg.mp3]	success
erfolgreich [sound:german-erfolgreich.mp3]	successful
plötzlich [sound:german-plötzlich.mp3]	suddenly
genügend [sound:german-genügend.mp3]	sufficient
der Zucker [sound:german-der Zucker.mp3]	sugar
empfehlen [sound:german-empfehlen.mp3]	suggest
der Anzug [sound:german-der Anzug.mp3]	suit
passen [sound:german-passen.mp3]	suit (verb)
der Sommer [sound:german-der Sommer.mp3]	summer
die Sonne [sound:german-die Sonne.mp3]	sun
der Sonntag [sound:german-der Sonntag.mp3]	Sunday
das Abendessen [sound:german-das Abendessen.mp3]	supper
unterstützen [sound:german-unterstützen.mp3]	support
die Oberfläche [sound:german-die Oberfläche.mp3]	surface
die Ueberraschung [sound:german-die Ueberraschung.mp3]	surprise
süss [sound:german-süss.mp3]	sweet
schwimmen [sound:german-schwimmen.mp3]	swim
die Tisch [sound:german-die Tisch.mp3]	table
nehmen [sound:german-nehmen.mp3]	take
reden [sound:german-reden.mp3]	talk
die Aufgabe [sound:german-die Aufgabe.mp3]	task
der Geschmack [sound:german-der Geschmack.mp3]	taste (noun)
abschmecken [sound:german-abschmecken.mp3]	taste (verb)
Steuern, pl [sound:german-Steuern, pl.mp3]	taxes
der Tee [sound:german-der Tee.mp3]	tea
lehren [sound:german-lehren.mp3]	teach
der Lehrer / die Lehrerin [sound:german-der Lehrer / die Lehrerin.mp3]	teacher
reissen [sound:german-reissen.mp3]	tear (verb)
Tränen, pl [sound:german-Tränen, pl.mp3]	tears
die Technik [sound:german-die Technik.mp3]	technique
das Telefon [sound:german-das Telefon.mp3]	telephone
das Fernseher [sound:german-das Fernseher.mp3]	television
erzählen [sound:german-erzählen.mp3]	tell
die Temperatur [sound:german-die Temperatur.mp3]	temperature
zehn [sound:german-zehn.mp3]	ten
die Spannung [sound:german-die Spannung.mp3]	tension
das Semester [sound:german-das Semester.mp3]	term
testen [sound:german-testen.mp3]	test
danken [sound:german-danken.mp3]	thank
danke [sound:german-danke.mp3]	thank you
das [sound:german-das.mp3]	that
der, die, das [sound:german-der, die, das.mp3]	the
die [sound:german-die.mp3]	the( plural)
das Theater [sound:german-das Theater.mp3]	theater
ihre [sound:german-ihre.mp3]	their
dann [sound:german-dann.mp3]	then
dort [sound:german-dort.mp3]	there
deswegen [sound:german-deswegen.mp3]	therefore
diese [sound:german-diese.mp3]	these
dick [sound:german-dick.mp3]	thick
dünn [sound:german-dünn.mp3]	thin
die Sache / das Ding [sound:german-die Sache / das Ding.mp3]	thing
denken [sound:german-denken.mp3]	to think
der Durst [sound:german-der Durst.mp3]	thirst
dreizehn [sound:german-dreizehn.mp3]	thirteen
dreißig [sound:german-dreissig.mp3]	thirty
heute morgen [sound:german-heute morgen.mp3]	this morning
der Gedanke [sound:german-der Gedanke.mp3]	thought
tausend [sound:german-tausend.mp3]	thousand
der Faden [sound:german-der Faden.mp3]	thread
drei [sound:german-drei.mp3]	three
werfen [sound:german-werfen.mp3]	throw
der Daumen, die Daumen [sound:german-der Daumen.mp3]	thumb
der Donner [sound:german-der Donner.mp3]	thunder
der Donnerstag [sound:german-der Donnerstag.mp3]	Thursday
so, darum [sound:german-so, darum.mp3]	thus
die Fahrkarte [sound:german-die Fahrkarte.mp3]	ticket
die Kravatte [sound:german-die Kravatte.mp3]	tie
der Tiger [sound:german-der Tiger.mp3]	tiger
bis [sound:german-bis.mp3]	till
die Zeit [sound:german-die Zeit.mp3]	time
mal [sound:german-mal.mp3]	times (many)
winzig [sound:german-winzig.mp3]	tiny
der Reifen [sound:german-der Reifen.mp3]	tire
müde [sound:german-müde.mp3]	tired
der Titel [sound:german-der Titel.mp3]	title
zu [sound:german-zu.mp3]	to
dir [sound:german-dir.mp3]	to you
heute [sound:german-heute.mp3]	today
die Zehe [sound:german-die Zehe.mp3]	toe
zusammen [sound:german-zusammen.mp3]	together
die Toilette [sound:german-die Toilette.mp3]	toilet
die Tomate [sound:german-die Tomate.mp3]	tomato
morgen [sound:german-morgen.mp3]	tomorrow
der Ton / der Klang [sound:german-der Ton / der Klang.mp3]	tone
die Zange [sound:german-die Zange.mp3]	tongs
die Zunge [sound:german-die Zunge.mp3]	tongue
zu viel [sound:german-zu viel.mp3]	too much
der Zahn [sound:german-der Zahn.mp3]	tooth
die Zahnbürste [sound:german-die Zahnbürste.mp3]	toothbrush
die Schildkröte [sound:german-die Schildkröte.mp3]	tortoise
total [sound:german-total.mp3]	total
berühren [sound:german-berühren.mp3]	touch
der Turm [sound:german-der Turm.mp3]	tower
die Stadt [sound:german-die Stadt.mp3]	town
der Handel [sound:german-der Handel.mp3]	trade
Ver [sound:german-Ver.mp3]	traffic
ehrgeizig [sound:german-ehrgeizig.mp3]	ambitious
Amerikaner [sound:german-Amerikaner.mp3]	American
ärgerlich [sound:german-ärgerlich.mp3]	annoying
blondine [sound:german-blondine.mp3]	blonde
langweilig [sound:german-langweilig.mp3]	boring
tapfer [sound:german-tapfer.mp3]	brave
unbesonnen [sound:german-unbesonnen.mp3]	careless
vorsichtig [sound:german-vorsichtig.mp3]	cautious
bestimmt [sound:german-bestimmt.mp3]	certain
charmant [sound:german-charmant.mp3]	charming
fröhlich [sound:german-fröhlich.mp3]	cheerful
Chinesisch [sound:german-Chinesisch.mp3]	Chinese
eingebildet [sound:german-eingebildet.mp3]	conceited
herkömmlich [sound:german-herkömmlich.mp3]	conventional
feigling [sound:german-feigling.mp3]	coward
verrückt, Nüsse [sound:german-verrückt, Nüsse.mp3]	crazy, nuts
grausam [sound:german-grausam.mp3]	cruel
schwierig [sound:german-schwierig.mp3]	difficult
unangenehm [sound:german-unangenehm.mp3]	disagreeable
dumm, langweilig [sound:german-dumm, langweilig.mp3]	dull, boring
Englisch [sound:german-Englisch.mp3]	English
unecht [sound:german-unecht.mp3]	fake
Fett [sound:german-Fett.mp3]	fat
wenige, ein wenig [sound:german-wenige, ein wenig.mp3]	few, a little
Französisch [sound:german-Französisch.mp3]	French
lustig, amüsant [sound:german-lustig, amüsant.mp3]	fun, amusing
komisch, komisch [sound:german-komisch, komisch.mp3]	funny
General [sound:german-General.mp3]	general
Deutsch [sound:german-Deutsch.mp3]	German
hoch, hoch [sound:german-hoch, hoch.mp3]	high, tall
intelligent [sound:german-intelligent.mp3]	intelligent
Art [sound:german-Art.mp3]	kind
entspannend [sound:german-entspannend.mp3]	laid-back
faul [sound:german-faul.mp3]	lazy
wenig, klein [sound:german-wenig, klein.mp3]	little, small
niedrig, kurz [sound:german-niedrig, kurz.mp3]	low, short
niedrig [sound:german-niedrig.mp3]	<span style=" font-style: normal; font-weight: normal;">humble,&nbsp;</span>mean (adj), low, base
bescheiden [sound:german-bescheiden.mp3]	modest
launisch [sound:german-launisch.mp3]	moody
naiv [sound:german-naiv.mp3]	naive
engstirnig [sound:german-engstirnig.mp3]	narrow-minded
nett [sound:german-nett.mp3]	nice (person)
vollkommen [sound:german-vollkommen.mp3]	perfect
Persönlicher [sound:german-Persönlicher.mp3]	personal
fromm [sound:german-fromm.mp3]	pious
höflich [sound:german-höflich.mp3]	polite
ziemlich [sound:german-ziemlich.mp3]	pretty
schnell, schnell [sound:german-schnell, schnell.mp3]	rapid, fast
realistisch [sound:german-realistisch.mp3]	realistic
zuverlässig [sound:german-zuverlässig.mp3]	reliable
jämmerlich [sound:german-jämmerlich.mp3]	sad
egoistisch [sound:german-egoistisch.mp3]	selfish
empfindlich [sound:german-empfindlich.mp3]	sensitive
schüchtern [sound:german-schüchtern.mp3]	shy
dumm, stumm [sound:german-dumm, stumm.mp3]	silly, dumb
schlank [sound:german-schlank.mp3]	slender, slim
Spanisch [sound:german-Spanisch.mp3]	Spanish
streng [sound:german-streng.mp3]	strict
störrisch [sound:german-störrisch.mp3]	stubborn
gesprächig [sound:german-gesprächig.mp3]	talkative
vertrauenswürdig [sound:german-vertrauenswürdig.mp3]	trustworthy
hässlich [sound:german-hässlich.mp3]	ugly
verschieden [sound:german-verschieden.mp3]	various
schwach [sound:german-schwach.mp3]	weak
unheimlich [sound:german-unheimlich.mp3]	weird
jung [sound:german-jung.mp3]	young
Hallo [sound:german-Hallo.mp3]	Hello
Guten Morgen [sound:german-Guten Morgen.mp3]	Good Morning
Guten Abend [sound:german-Guten Abend.mp3]	Good Evening
Auf wiedersehen [sound:german-Auf wiedersehen.mp3]	Goodbye!
Bis bald [sound:german-Bis bald.mp3]	See you!
Bis dann [sound:german-Bis dann.mp3]	So long
Ich lebe in Berlin [sound:german-Ich lebe in Berlin.mp3]	I live in Berlin
Ich bin Student [sound:german-Ich bin Student.mp3]	I'm a student
Ich komme aus England [sound:german-Ich komme aus England.mp3]	I'm from England
Ich bin ledig [sound:german-Ich bin ledig.mp3]	I'm single
Ich bin verheiratet [sound:german-Ich bin verheiratet.mp3]	I'm married
Ich verstehe nicht [sound:german-Ich verstehe nicht.mp3]	I don’t understand
Macht nichts [sound:german-Macht nichts.mp3]	Don't worry about it
Dankeschön [sound:german-Dankeschön.mp3]	Thanks a lot
Es tut mir leid [sound:german-Es tut mir leid.mp3]	I'm sorry
Kassenzettel [sound:german-Kassenzettel.mp3]	receipt
heute/ jetzt [sound:german-heute/ jetzt.mp3]	Today/ Now
morgen/ gestern [sound:german-morgen/ gestern.mp3]	Tomorrow/ Yesterday
ja / nein [sound:german-ja.mp3]&nbsp;<span style=" font-style: normal; font-weight: normal;">[sound:german-nein.mp3]</span>	Yes / No
am Morgen/ morgens/ am Abend/ abends/ in der Nacht [sound:german-am Morgen/ morgens/ am Abend/ abends/ in der Nacht.mp3]	In The Morning/ Evening/ At Night.
eins, zwei, drei [sound:german-eins, zwei, drei.mp3]	One, Two, Three
vier, fünf, sechs [sound:german-vier, fünf, sechs.mp3]	Four, Five, Six
sieben, acht, neun, zehn [sound:german-sieben, acht, neun, zehn.mp3]	Seven, Eight, Nine, Ten
Ich möchte eines Tages (mal) nach Deutschland reisen [sound:german-Ich möchte eines Tages (mal) nach Deutschland reisen.mp3]	I'd Like To Visit Germany One Day
Herr/ Frau/ Fräulein (not used anymore) [sound:german-Herr/ Frau/ Fräulein (not used anymore).mp3]	Mr.../ Mrs.…/ Miss…
Ich bin (Amerikaner) [sound:german-Ich bin (Amerikaner).mp3]	I’m (American)
Ich bin (Übersetzer/Dolmetscher) / Geschäftsmann [sound:german-Ich bin (Übersetzer/Dolmetscher) / Geschäftsmann.mp3]	I Work As A (Translator/ Businessman)
Ich mag Deutsch [sound:german-Ich mag Deutsch.mp3]	I Like German
Ich lerne seit einem Monat Deutsch [sound:german-Ich lerne seit einem Monat Deutsch.mp3]	I've Been Learning German For 1 Month
